111111111111111111111111
100000000000000000000001
100101000000000000000001
100000000000000000100001
100001000000001001000001
100000000000000000000001
100001000001000000000001
100000000000000000000001
111111111111111111111111



